####B#########
###  ########
#   ##########
###  ##   ##
####  ##### ##
#####  #######
######  ######
#######   ####
##### ### ####
####  ###A####